|BBBB|||||MAP||||||BBB|
|BBBB..............BBB|
|.....................|
|........_____........|
|.......|     |.......|
|.......|_____|.......|
|...............X.....|
|.....................|
|w.....[]............w|
