|BB||||||||||||||||||||
|BB.......TV.......LLL|
|.....................|
|........_____........|
|.......|     |.M.....|
|.......|_____|.......|
|.....................|
|.....................|
|......[].............|
