||||||||||||||||||||||
|PC__|............LLL|
|....................|
|....................|
|.........TV.........|
|....................|
|B...................|
|E...................|
|D...................|
