||||||||||||||||||||||||||
|PC..........X.....000...|
|..........R.............|
|________........________|
|        |......|        |
|TTTTTTTT|..C...|TTTTTTTT|
|.G.................S....|
|.....S..................|
|___________[]___________|
