||||||||||||||||||||||||||
|PC..........X.....000...|
|..........R.............|
|________........________|
|        |......|        |
|TTTTTTTT|......|TTTTTTTT|
|........................|
|.G...S.......S..........|
|___________[]___________|
