||||||||||||||||||||||||||
|............X.....000...|
|..........R.............|
|________......._________|
|        |......|        |
|TTTTTTTT|......TTTTTTTTT|
|.G.................S....|
|.....S..................|
|___________[]___________|
