.[]...........
.||....O.O....
O||.........[]
.||O......O...
.||.w...ww....
w||w.w..wwwwww
